YEAR,FIRST ROUND,SECOND ROUND,SWEET 16,ELITE 8,FINAL 4,TOTAL
2023,5,4,3,2,0,14
2022,7,5,4,0,1,17
2021,9,6,2,1,0,18
2019,8,0,1,2,0,11
2018,6,5,3,1,0,15
2017,5,4,2,2,0,13
2016,10,2,0,1,0,13
2015,5,3,1,1,0,10
2014,7,5,3,2,2,19
2013,8,3,2,1,0,14
2012,9,2,2,0,0,13
2011,6,4,3,3,0,16
2010,8,5,2,1,0,16
2009,8,0,0,1,0,9
2008,6,2,1,0,0,9